--------------------
-------WWWWWW-------
------WWWWWWWWW-----
-----WW-------------
----WW--------------
----WWW-------------
----WWW-------------
----WW--------------
-----WW-------------
W-----WWWWWWW------W
W-----WWWWWWW------W
-----WW-------------
----WW--------------
----WWW-------------
----WWW-------------
----WW--------------
-----WW-------------
------WWWWWWWWW-----
-------WWWWWW-------
--------------------
