--B-B-B-B-B-B-B---B-B-B-B-B-B-B--
-WBWBWBWBWBWBWBW-WBWBWBWBWBWBWBW-
BBB-B-B-B-B-B-B---B-B-B-B-B-B-BBB
-W-WBWBWBWBWBWBW-WBWBWBWBWBWBW-W-
BBBBB-B-B-B-B-B---B-B-B-B-B-BBBBB
-W-W-WBWBWBWBWBW-WBWBWBWBWBW-W-W-
BBBBBBB-B-B-B-B---B-B-B-B-BBBBBBB
-W-W-W-WBWBWBWBW-WBWBWBWBW-W-W-W-
BBBBBBBBB-B-B-B---B-B-B-BBBBBBBBB
-W-W-W-W-WBWBWBW-WBWBWBW-W-W-W-W-
BBBBBBBBBBB-B-B---B-B-BBBBBBBBBBB
-W-W-W-W-W-WBWBW-WBWBW-W-W-W-W-W-
BBBBBBBBBBBBB-B---B-BBBBBBBBBBBBB
-W-W-W-W-W-W-WBW-WBW-W-W-W-W-W-W-
BBBBBBBBBBBBBBB---BBBBBBBBBBBBBBB
-W-W-W-W-W-W-W-W-W-W-W-W-W-W-W-W-
---------------------------------
-W-W-W-W-W-W-W-W-W-W-W-W-W-W-W-W-
BBBBBBBBBBBBBBB---BBBBBBBBBBBBBBB
-W-W-W-W-W-W-WBW-WBW-W-W-W-W-W-W-
BBBBBBBBBBBBB-B---B-BBBBBBBBBBBBB
-W-W-W-W-W-WBWBW-WBWBW-W-W-W-W-W-
BBBBBBBBBBB-B-B---B-B-BBBBBBBBBBB
-W-W-W-W-WBWBWBW-WBWBWBW-W-W-W-W-
BBBBBBBBB-B-B-B---B-B-B-BBBBBBBBB
-W-W-W-WBWBWBWBW-WBWBWBWBW-W-W-W-
BBBBBBB-B-B-B-B---B-B-B-B-BBBBBBB
-W-W-WBWBWBWBWBW-WBWBWBWBWBW-W-W-
BBBBB-B-B-B-B-B---B-B-B-B-B-BBBBB
-W-WBWBWBWBWBWBW-WBWBWBWBWBWBW-W-
BBB-B-B-B-B-B-B---B-B-B-B-B-B-BBB
-WBWBWBWBWBWBWBW-WBWBWBWBWBWBWBW-
--B-B-B-B-B-B-B---B-B-B-B-B-B-B--
