--B-B-B-B-B-B-B-B--
-WBWBWBWBWBWBWBWBW-
BBB-B-B-B-B-B-B-BBB
-W-WBWBWBWBWBWBW-W-
BBBBB-B-B-B-B-BBBBB
-W-W-WBWBWBWBW-W-W-
BBBBBBB-B-B-BBBBBBB
-W-W-W-WBWBW-W-W-W-
BBBBBBBBB-BBBBBBBBB
-W-W-W-W-W-W-W-W-W-
BBBBBBBBB-BBBBBBBBB
-W-W-W-WBWBW-W-W-W-
BBBBBBB-B-B-BBBBBBB
-W-W-WBWBWBWBW-W-W-
BBBBB-B-B-B-B-BBBBB
-W-WBWBWBWBWBWBW-W-
BBB-B-B-B-B-B-B-BBB
-WBWBWBWBWBWBWBWBW-
--B-B-B-B-B-B-B-B--
