--B-B-B-B-B-B-B-B-B-B-B-B-B-B-B-B-B---B-B-B-B-B-B-B-B-B-B-B-B-B-B-B-B-B--
-WBWBWBWBWBWBWBWBWBWBWBWBWBWBWBWBWBW-WBWBWBWBWBWBWBWBWBWBWBWBWBWBWBWBWBW-
BBB-B-B-B-B-B-B-B-B-B-B-B-B-B-B-B-B---B-B-B-B-B-B-B-B-B-B-B-B-B-B-B-B-BBB
-W-WBWBWBWBWBWBWBWBWBWBWBWBWBWBWBWBW-WBWBWBWBWBWBWBWBWBWBWBWBWBWBWBWBW-W-
BBBBB-B-B-B-B-B-B-B-B-B-B-B-B-B-B-B---B-B-B-B-B-B-B-B-B-B-B-B-B-B-B-BBBBB
-W-W-WBWBWBWBWBWBWBWBWBWBWBWBWBWBWBW-WBWBWBWBWBWBWBWBWBWBWBWBWBWBWBW-W-W-
BBBBBBB-B-B-B-B-B-B-B-B-B-B-B-B-B-B---B-B-B-B-B-B-B-B-B-B-B-B-B-B-BBBBBBB
-W-W-W-WBWBWBWBWBWBWBWBWBWBWBWBWBWBW-WBWBWBWBWBWBWBWBWBWBWBWBWBWBW-W-W-W-
BBBBBBBBB-B-B-B-B-B-B-B-B-B-B-B-B-B---B-B-B-B-B-B-B-B-B-B-B-B-B-BBBBBBBBB
-W-W-W-W-WBWBWBWBWBWBWBWBWBWBWBWBWBW-WBWBWBWBWBWBWBWBWBWBWBWBWBW-W-W-W-W-
BBBBBBBBBBB-B-B-B-B-B-B-B-B-B-B-B-B---B-B-B-B-B-B-B-B-B-B-B-B-BBBBBBBBBBB
-W-W-W-W-W-WBWBWBWBWBWBWBWBWBWBWBWBW-WBWBWBWBWBWBWBWBWBWBWBWBW-W-W-W-W-W-
BBBBBBBBBBBBB-B-B-B-B-B-B-B-B-B-B-B---B-B-B-B-B-B-B-B-B-B-B-BBBBBBBBBBBBB
-W-W-W-W-W-W-WBWBWBWBWBWBWBWBWBWBWBW-WBWBWBWBWBWBWBWBWBWBWBW-W-W-W-W-W-W-
BBBBBBBBBBBBBBB-B-B-B-B-B-B-B-B-B-B---B-B-B-B-B-B-B-B-B-B-BBBBBBBBBBBBBBB
-W-W-W-W-W-W-W-WBWBWBWBWBWBWBWBWBWBW-WBWBWBWBWBWBWBWBWBWBW-W-W-W-W-W-W-W-
BBBBBBBBBBBBBBBBB-B-B-B-B-B-B-B-B-B---B-B-B-B-B-B-B-B-B-BBBBBBBBBBBBBBBBB
-W-W-W-W-W-W-W-W-WBWBWBWBWBWBWBWBWBW-WBWBWBWBWBWBWBWBWBW-W-W-W-W-W-W-W-W-
BBBBBBBBBBBBBBBBBBB-B-B-B-B-B-B-B-B---B-B-B-B-B-B-B-B-BBBBBBBBBBBBBBBBBBB
-W-W-W-W-W-W-W-W-W-WBWBWBWBWBWBWBWBW-WBWBWBWBWBWBWBWBW-W-W-W-W-W-W-W-W-W-
BBBBBBBBBBBBBBBBBBBBB-B-B-B-B-B-B-B---B-B-B-B-B-B-B-BBBBBBBBBBBBBBBBBBBBB
-W-W-W-W-W-W-W-W-W-W-WBWBWBWBWBWBWBW-WBWBWBWBWBWBWBW-W-W-W-W-W-W-W-W-W-W-
BBBBBBBBBBBBBBBBBBBBBBB-B-B-B-B-B-B---B-B-B-B-B-B-BBBBBBBBBBBBBBBBBBBBBBB
-W-W-W-W-W-W-W-W-W-W-W-WBWBWBWBWBWBW-WBWBWBWBWBWBW-W-W-W-W-W-W-W-W-W-W-W-
BBBBBBBBBBBBBBBBBBBBBBBBB-B-B-B-B-B---B-B-B-B-B-BBBBBBBBBBBBBBBBBBBBBBBBB
-W-W-W-W-W-W-W-W-W-W-W-W-WBWBWBWBWBW-WBWBWBWBWBW-W-W-W-W-W-W-W-W-W-W-W-W-
BBBBBBBBBBBBBBBBBBBBBBBBBBB-B-B-B-B---B-B-B-B-BBBBBBBBBBBBBBBBBBBBBBBBBBB
-W-W-W-W-W-W-W-W-W-W-W-W-W-WBWBWBWBW-WBWBWBWBW-W-W-W-W-W-W-W-W-W-W-W-W-W-
BBBBBBBBBBBBBBBBBBBBBBBBBBBBB-B-B-B---B-B-B-BBBBBBBBBBBBBBBBBBBBBBBBBBBBB
-W-W-W-W-W-W-W-W-W-W-W-W-W-W-WBWBWBW-WBWBWBW-W-W-W-W-W-W-W-W-W-W-W-W-W-W-
BBBBBBBBBBBBBBBBBBBBBBBBBBBBBBB-B-B---B-B-BBBBBBBBBBBBBBBBBBBBBBBBBBBBBBB
-W-W-W-W-W-W-W-W-W-W-W-W-W-W-W-WBWBW-WBWBW-W-W-W-W-W-W-W-W-W-W-W-W-W-W-W-
BBBBBBBBBBBBBBBBBBBBBBBBBBBBBBBBB-B---B-BBBBBBBBBBBBBBBBBBBBBBBBBBBBBBBBB
-W-W-W-W-W-W-W-W-W-W-W-W-W-W-W-W-WBW-WBW-W-W-W-W-W-W-W-W-W-W-W-W-W-W-W-W-
BBBBBBBBBBBBBBBBBBBBBBBBBBBBBBBBBBB---BBBBBBBBBBBBBBBBBBBBBBBBBBBBBBBBBBB
-W-W-W-W-W-W-W-W-W-W-W-W-W-W-W-W-W-W-W-W-W-W-W-W-W-W-W-W-W-W-W-W-W-W-W-W-
-------------------------------------------------------------------------
-W-W-W-W-W-W-W-W-W-W-W-W-W-W-W-W-W-W-W-W-W-W-W-W-W-W-W-W-W-W-W-W-W-W-W-W-
BBBBBBBBBBBBBBBBBBBBBBBBBBBBBBBBBBB---BBBBBBBBBBBBBBBBBBBBBBBBBBBBBBBBBBB
-W-W-W-W-W-W-W-W-W-W-W-W-W-W-W-W-WBW-WBW-W-W-W-W-W-W-W-W-W-W-W-W-W-W-W-W-
BBBBBBBBBBBBBBBBBBBBBBBBBBBBBBBBB-B---B-BBBBBBBBBBBBBBBBBBBBBBBBBBBBBBBBB
-W-W-W-W-W-W-W-W-W-W-W-W-W-W-W-WBWBW-WBWBW-W-W-W-W-W-W-W-W-W-W-W-W-W-W-W-
BBBBBBBBBBBBBBBBBBBBBBBBBBBBBBB-B-B---B-B-BBBBBBBBBBBBBBBBBBBBBBBBBBBBBBB
-W-W-W-W-W-W-W-W-W-W-W-W-W-W-WBWBWBW-WBWBWBW-W-W-W-W-W-W-W-W-W-W-W-W-W-W-
BBBBBBBBBBBBBBBBBBBBBBBBBBBBB-B-B-B---B-B-B-BBBBBBBBBBBBBBBBBBBBBBBBBBBBB
-W-W-W-W-W-W-W-W-W-W-W-W-W-WBWBWBWBW-WBWBWBWBW-W-W-W-W-W-W-W-W-W-W-W-W-W-
BBBBBBBBBBBBBBBBBBBBBBBBBBB-B-B-B-B---B-B-B-B-BBBBBBBBBBBBBBBBBBBBBBBBBBB
-W-W-W-W-W-W-W-W-W-W-W-W-WBWBWBWBWBW-WBWBWBWBWBW-W-W-W-W-W-W-W-W-W-W-W-W-
BBBBBBBBBBBBBBBBBBBBBBBBB-B-B-B-B-B---B-B-B-B-B-BBBBBBBBBBBBBBBBBBBBBBBBB
-W-W-W-W-W-W-W-W-W-W-W-WBWBWBWBWBWBW-WBWBWBWBWBWBW-W-W-W-W-W-W-W-W-W-W-W-
BBBBBBBBBBBBBBBBBBBBBBB-B-B-B-B-B-B---B-B-B-B-B-B-BBBBBBBBBBBBBBBBBBBBBBB
-W-W-W-W-W-W-W-W-W-W-WBWBWBWBWBWBWBW-WBWBWBWBWBWBWBW-W-W-W-W-W-W-W-W-W-W-
BBBBBBBBBBBBBBBBBBBBB-B-B-B-B-B-B-B---B-B-B-B-B-B-B-BBBBBBBBBBBBBBBBBBBBB
-W-W-W-W-W-W-W-W-W-WBWBWBWBWBWBWBWBW-WBWBWBWBWBWBWBWBW-W-W-W-W-W-W-W-W-W-
BBBBBBBBBBBBBBBBBBB-B-B-B-B-B-B-B-B---B-B-B-B-B-B-B-B-BBBBBBBBBBBBBBBBBBB
-W-W-W-W-W-W-W-W-WBWBWBWBWBWBWBWBWBW-WBWBWBWBWBWBWBWBWBW-W-W-W-W-W-W-W-W-
BBBBBBBBBBBBBBBBB-B-B-B-B-B-B-B-B-B---B-B-B-B-B-B-B-B-B-BBBBBBBBBBBBBBBBB
-W-W-W-W-W-W-W-WBWBWBWBWBWBWBWBWBWBW-WBWBWBWBWBWBWBWBWBWBW-W-W-W-W-W-W-W-
BBBBBBBBBBBBBBB-B-B-B-B-B-B-B-B-B-B---B-B-B-B-B-B-B-B-B-B-BBBBBBBBBBBBBBB
-W-W-W-W-W-W-WBWBWBWBWBWBWBWBWBWBWBW-WBWBWBWBWBWBWBWBWBWBWBW-W-W-W-W-W-W-
BBBBBBBBBBBBB-B-B-B-B-B-B-B-B-B-B-B---B-B-B-B-B-B-B-B-B-B-B-BBBBBBBBBBBBB
-W-W-W-W-W-WBWBWBWBWBWBWBWBWBWBWBWBW-WBWBWBWBWBWBWBWBWBWBWBWBW-W-W-W-W-W-
BBBBBBBBBBB-B-B-B-B-B-B-B-B-B-B-B-B---B-B-B-B-B-B-B-B-B-B-B-B-BBBBBBBBBBB
-W-W-W-W-WBWBWBWBWBWBWBWBWBWBWBWBWBW-WBWBWBWBWBWBWBWBWBWBWBWBWBW-W-W-W-W-
BBBBBBBBB-B-B-B-B-B-B-B-B-B-B-B-B-B---B-B-B-B-B-B-B-B-B-B-B-B-B-BBBBBBBBB
-W-W-W-WBWBWBWBWBWBWBWBWBWBWBWBWBWBW-WBWBWBWBWBWBWBWBWBWBWBWBWBWBW-W-W-W-
BBBBBBB-B-B-B-B-B-B-B-B-B-B-B-B-B-B---B-B-B-B-B-B-B-B-B-B-B-B-B-B-BBBBBBB
-W-W-WBWBWBWBWBWBWBWBWBWBWBWBWBWBWBW-WBWBWBWBWBWBWBWBWBWBWBWBWBWBWBW-W-W-
BBBBB-B-B-B-B-B-B-B-B-B-B-B-B-B-B-B---B-B-B-B-B-B-B-B-B-B-B-B-B-B-B-BBBBB
-W-WBWBWBWBWBWBWBWBWBWBWBWBWBWBWBWBW-WBWBWBWBWBWBWBWBWBWBWBWBWBWBWBWBW-W-
BBB-B-B-B-B-B-B-B-B-B-B-B-B-B-B-B-B---B-B-B-B-B-B-B-B-B-B-B-B-B-B-B-B-BBB
-WBWBWBWBWBWBWBWBWBWBWBWBWBWBWBWBWBW-WBWBWBWBWBWBWBWBWBWBWBWBWBWBWBWBWBW-
--B-B-B-B-B-B-B-B-B-B-B-B-B-B-B-B-B---B-B-B-B-B-B-B-B-B-B-B-B-B-B-B-B-B--
