--B-B-B-B---B-B-B-B--
-WBWBWBWBW-WBWBWBWBW-
BBB-B-B-B---B-B-B-BBB
-W-WBWBWBW-WBWBWBW-W-
BBBBB-B-B---B-B-BBBBB
-W-W-WBWBW-WBWBW-W-W-
BBBBBBB-B---B-BBBBBBB
-W-W-W-WBW-WBW-W-W-W-
BBBBBBBBB---BBBBBBBBB
-W-W-W-W-W-W-W-W-W-W-
---------------------
-W-W-W-W-W-W-W-W-W-W-
BBBBBBBBB---BBBBBBBBB
-W-W-W-WBW-WBW-W-W-W-
BBBBBBB-B---B-BBBBBBB
-W-W-WBWBW-WBWBW-W-W-
BBBBB-B-B---B-B-BBBBB
-W-WBWBWBW-WBWBWBW-W-
BBB-B-B-B---B-B-B-BBB
-WBWBWBWBW-WBWBWBWBW-
--B-B-B-B---B-B-B-B--
