--B-B-B-B-B-B-B-B-B---B-B-B-B-B-B-B-B-B--
-WBWBWBWBWBWBWBWBWBW-WBWBWBWBWBWBWBWBWBW-
BBB-B-B-B-B-B-B-B-B---B-B-B-B-B-B-B-B-BBB
-W-WBWBWBWBWBWBWBWBW-WBWBWBWBWBWBWBWBW-W-
BBBBB-B-B-B-B-B-B-B---B-B-B-B-B-B-B-BBBBB
-W-W-WBWBWBWBWBWBWBW-WBWBWBWBWBWBWBW-W-W-
BBBBBBB-B-B-B-B-B-B---B-B-B-B-B-B-BBBBBBB
-W-W-W-WBWBWBWBWBWBW-WBWBWBWBWBWBW-W-W-W-
BBBBBBBBB-B-B-B-B-B---B-B-B-B-B-BBBBBBBBB
-W-W-W-W-WBWBWBWBWBW-WBWBWBWBWBW-W-W-W-W-
BBBBBBBBBBB-B-B-B-B---B-B-B-B-BBBBBBBBBBB
-W-W-W-W-W-WBWBWBWBW-WBWBWBWBW-W-W-W-W-W-
BBBBBBBBBBBBB-B-B-B---B-B-B-BBBBBBBBBBBBB
-W-W-W-W-W-W-WBWBWBW-WBWBWBW-W-W-W-W-W-W-
BBBBBBBBBBBBBBB-B-B---B-B-BBBBBBBBBBBBBBB
-W-W-W-W-W-W-W-WBWBW-WBWBW-W-W-W-W-W-W-W-
BBBBBBBBBBBBBBBBB-B---B-BBBBBBBBBBBBBBBBB
-W-W-W-W-W-W-W-W-WBW-WBW-W-W-W-W-W-W-W-W-
BBBBBBBBBBBBBBBBBBB---BBBBBBBBBBBBBBBBBBB
-W-W-W-W-W-W-W-W-W-W-W-W-W-W-W-W-W-W-W-W-
-----------------------------------------
-W-W-W-W-W-W-W-W-W-W-W-W-W-W-W-W-W-W-W-W-
BBBBBBBBBBBBBBBBBBB---BBBBBBBBBBBBBBBBBBB
-W-W-W-W-W-W-W-W-WBW-WBW-W-W-W-W-W-W-W-W-
BBBBBBBBBBBBBBBBB-B---B-BBBBBBBBBBBBBBBBB
-W-W-W-W-W-W-W-WBWBW-WBWBW-W-W-W-W-W-W-W-
BBBBBBBBBBBBBBB-B-B---B-B-BBBBBBBBBBBBBBB
-W-W-W-W-W-W-WBWBWBW-WBWBWBW-W-W-W-W-W-W-
BBBBBBBBBBBBB-B-B-B---B-B-B-BBBBBBBBBBBBB
-W-W-W-W-W-WBWBWBWBW-WBWBWBWBW-W-W-W-W-W-
BBBBBBBBBBB-B-B-B-B---B-B-B-B-BBBBBBBBBBB
-W-W-W-W-WBWBWBWBWBW-WBWBWBWBWBW-W-W-W-W-
BBBBBBBBB-B-B-B-B-B---B-B-B-B-B-BBBBBBBBB
-W-W-W-WBWBWBWBWBWBW-WBWBWBWBWBWBW-W-W-W-
BBBBBBB-B-B-B-B-B-B---B-B-B-B-B-B-BBBBBBB
-W-W-WBWBWBWBWBWBWBW-WBWBWBWBWBWBWBW-W-W-
BBBBB-B-B-B-B-B-B-B---B-B-B-B-B-B-B-BBBBB
-W-WBWBWBWBWBWBWBWBW-WBWBWBWBWBWBWBWBW-W-
BBB-B-B-B-B-B-B-B-B---B-B-B-B-B-B-B-B-BBB
-WBWBWBWBWBWBWBWBWBW-WBWBWBWBWBWBWBWBWBW-
--B-B-B-B-B-B-B-B-B---B-B-B-B-B-B-B-B-B--
