--B-B-B-B-B-B-B-B-B-B-B-B-B-B-B-B-B-B-B-B-B-B-B-B-B-B-B-B-B-B--
-WBWBWBWBWBWBWBWBWBWBWBWBWBWBWBWBWBWBWBWBWBWBWBWBWBWBWBWBWBWBW-
BBB-B-B-B-B-B-B-B-B-B-B-B-B-B-B-B-B-B-B-B-B-B-B-B-B-B-B-B-B-BBB
-W-WBWBWBWBWBWBWBWBWBWBWBWBWBWBWBWBWBWBWBWBWBWBWBWBWBWBWBWBW-W-
BBBBB-B-B-B-B-B-B-B-B-B-B-B-B-B-B-B-B-B-B-B-B-B-B-B-B-B-B-BBBBB
-W-W-WBWBWBWBWBWBWBWBWBWBWBWBWBWBWBWBWBWBWBWBWBWBWBWBWBWBW-W-W-
BBBBBBB-B-B-B-B-B-B-B-B-B-B-B-B-B-B-B-B-B-B-B-B-B-B-B-B-BBBBBBB
-W-W-W-WBWBWBWBWBWBWBWBWBWBWBWBWBWBWBWBWBWBWBWBWBWBWBWBW-W-W-W-
BBBBBBBBB-B-B-B-B-B-B-B-B-B-B-B-B-B-B-B-B-B-B-B-B-B-B-BBBBBBBBB
-W-W-W-W-WBWBWBWBWBWBWBWBWBWBWBWBWBWBWBWBWBWBWBWBWBWBW-W-W-W-W-
BBBBBBBBBBB-B-B-B-B-B-B-B-B-B-B-B-B-B-B-B-B-B-B-B-B-BBBBBBBBBBB
-W-W-W-W-W-WBWBWBWBWBWBWBWBWBWBWBWBWBWBWBWBWBWBWBWBW-W-W-W-W-W-
BBBBBBBBBBBBB-B-B-B-B-B-B-B-B-B-B-B-B-B-B-B-B-B-B-BBBBBBBBBBBBB
-W-W-W-W-W-W-WBWBWBWBWBWBWBWBWBWBWBWBWBWBWBWBWBWBW-W-W-W-W-W-W-
BBBBBBBBBBBBBBB-B-B-B-B-B-B-B-B-B-B-B-B-B-B-B-B-BBBBBBBBBBBBBBB
-W-W-W-W-W-W-W-WBWBWBWBWBWBWBWBWBWBWBWBWBWBWBWBW-W-W-W-W-W-W-W-
BBBBBBBBBBBBBBBBB-B-B-B-B-B-B-B-B-B-B-B-B-B-B-BBBBBBBBBBBBBBBBB
-W-W-W-W-W-W-W-W-WBWBWBWBWBWBWBWBWBWBWBWBWBWBW-W-W-W-W-W-W-W-W-
BBBBBBBBBBBBBBBBBBB-B-B-B-B-B-B-B-B-B-B-B-B-BBBBBBBBBBBBBBBBBBB
-W-W-W-W-W-W-W-W-W-WBWBWBWBWBWBWBWBWBWBWBWBW-W-W-W-W-W-W-W-W-W-
BBBBBBBBBBBBBBBBBBBBB-B-B-B-B-B-B-B-B-B-B-BBBBBBBBBBBBBBBBBBBBB
-W-W-W-W-W-W-W-W-W-W-WBWBWBWBWBWBWBWBWBWBW-W-W-W-W-W-W-W-W-W-W-
BBBBBBBBBBBBBBBBBBBBBBB-B-B-B-B-B-B-B-B-BBBBBBBBBBBBBBBBBBBBBBB
-W-W-W-W-W-W-W-W-W-W-W-WBWBWBWBWBWBWBWBW-W-W-W-W-W-W-W-W-W-W-W-
BBBBBBBBBBBBBBBBBBBBBBBBB-B-B-B-B-B-B-BBBBBBBBBBBBBBBBBBBBBBBBB
-W-W-W-W-W-W-W-W-W-W-W-W-WBWBWBWBWBWBW-W-W-W-W-W-W-W-W-W-W-W-W-
BBBBBBBBBBBBBBBBBBBBBBBBBBB-B-B-B-B-BBBBBBBBBBBBBBBBBBBBBBBBBBB
-W-W-W-W-W-W-W-W-W-W-W-W-W-WBWBWBWBW-W-W-W-W-W-W-W-W-W-W-W-W-W-
BBBBBBBBBBBBBBBBBBBBBBBBBBBBB-B-B-BBBBBBBBBBBBBBBBBBBBBBBBBBBBB
-W-W-W-W-W-W-W-W-W-W-W-W-W-W-WBWBW-W-W-W-W-W-W-W-W-W-W-W-W-W-W-
BBBBBBBBBBBBBBBBBBBBBBBBBBBBBBB-BBBBBBBBBBBBBBBBBBBBBBBBBBBBBBB
-W-W-W-W-W-W-W-W-W-W-W-W-W-W-W-W-W-W-W-W-W-W-W-W-W-W-W-W-W-W-W-
BBBBBBBBBBBBBBBBBBBBBBBBBBBBBBB-BBBBBBBBBBBBBBBBBBBBBBBBBBBBBBB
-W-W-W-W-W-W-W-W-W-W-W-W-W-W-WBWBW-W-W-W-W-W-W-W-W-W-W-W-W-W-W-
BBBBBBBBBBBBBBBBBBBBBBBBBBBBB-B-B-BBBBBBBBBBBBBBBBBBBBBBBBBBBBB
-W-W-W-W-W-W-W-W-W-W-W-W-W-WBWBWBWBW-W-W-W-W-W-W-W-W-W-W-W-W-W-
BBBBBBBBBBBBBBBBBBBBBBBBBBB-B-B-B-B-BBBBBBBBBBBBBBBBBBBBBBBBBBB
-W-W-W-W-W-W-W-W-W-W-W-W-WBWBWBWBWBWBW-W-W-W-W-W-W-W-W-W-W-W-W-
BBBBBBBBBBBBBBBBBBBBBBBBB-B-B-B-B-B-B-BBBBBBBBBBBBBBBBBBBBBBBBB
-W-W-W-W-W-W-W-W-W-W-W-WBWBWBWBWBWBWBWBW-W-W-W-W-W-W-W-W-W-W-W-
BBBBBBBBBBBBBBBBBBBBBBB-B-B-B-B-B-B-B-B-BBBBBBBBBBBBBBBBBBBBBBB
-W-W-W-W-W-W-W-W-W-W-WBWBWBWBWBWBWBWBWBWBW-W-W-W-W-W-W-W-W-W-W-
BBBBBBBBBBBBBBBBBBBBB-B-B-B-B-B-B-B-B-B-B-BBBBBBBBBBBBBBBBBBBBB
-W-W-W-W-W-W-W-W-W-WBWBWBWBWBWBWBWBWBWBWBWBW-W-W-W-W-W-W-W-W-W-
BBBBBBBBBBBBBBBBBBB-B-B-B-B-B-B-B-B-B-B-B-B-BBBBBBBBBBBBBBBBBBB
-W-W-W-W-W-W-W-W-WBWBWBWBWBWBWBWBWBWBWBWBWBWBW-W-W-W-W-W-W-W-W-
BBBBBBBBBBBBBBBBB-B-B-B-B-B-B-B-B-B-B-B-B-B-B-BBBBBBBBBBBBBBBBB
-W-W-W-W-W-W-W-WBWBWBWBWBWBWBWBWBWBWBWBWBWBWBWBW-W-W-W-W-W-W-W-
BBBBBBBBBBBBBBB-B-B-B-B-B-B-B-B-B-B-B-B-B-B-B-B-BBBBBBBBBBBBBBB
-W-W-W-W-W-W-WBWBWBWBWBWBWBWBWBWBWBWBWBWBWBWBWBWBW-W-W-W-W-W-W-
BBBBBBBBBBBBB-B-B-B-B-B-B-B-B-B-B-B-B-B-B-B-B-B-B-BBBBBBBBBBBBB
-W-W-W-W-W-WBWBWBWBWBWBWBWBWBWBWBWBWBWBWBWBWBWBWBWBW-W-W-W-W-W-
BBBBBBBBBBB-B-B-B-B-B-B-B-B-B-B-B-B-B-B-B-B-B-B-B-B-BBBBBBBBBBB
-W-W-W-W-WBWBWBWBWBWBWBWBWBWBWBWBWBWBWBWBWBWBWBWBWBWBW-W-W-W-W-
BBBBBBBBB-B-B-B-B-B-B-B-B-B-B-B-B-B-B-B-B-B-B-B-B-B-B-BBBBBBBBB
-W-W-W-WBWBWBWBWBWBWBWBWBWBWBWBWBWBWBWBWBWBWBWBWBWBWBWBW-W-W-W-
BBBBBBB-B-B-B-B-B-B-B-B-B-B-B-B-B-B-B-B-B-B-B-B-B-B-B-B-BBBBBBB
-W-W-WBWBWBWBWBWBWBWBWBWBWBWBWBWBWBWBWBWBWBWBWBWBWBWBWBWBW-W-W-
BBBBB-B-B-B-B-B-B-B-B-B-B-B-B-B-B-B-B-B-B-B-B-B-B-B-B-B-B-BBBBB
-W-WBWBWBWBWBWBWBWBWBWBWBWBWBWBWBWBWBWBWBWBWBWBWBWBWBWBWBWBW-W-
BBB-B-B-B-B-B-B-B-B-B-B-B-B-B-B-B-B-B-B-B-B-B-B-B-B-B-B-B-B-BBB
-WBWBWBWBWBWBWBWBWBWBWBWBWBWBWBWBWBWBWBWBWBWBWBWBWBWBWBWBWBWBW-
--B-B-B-B-B-B-B-B-B-B-B-B-B-B-B-B-B-B-B-B-B-B-B-B-B-B-B-B-B-B--
