--B-B-B-B-B-B-B-B-B-B---B-B-B-B-B-B-B-B-B-B--
-WBWBWBWBWBWBWBWBWBWBW-WBWBWBWBWBWBWBWBWBWBW-
BBB-B-B-B-B-B-B-B-B-B---B-B-B-B-B-B-B-B-B-BBB
-W-WBWBWBWBWBWBWBWBWBW-WBWBWBWBWBWBWBWBWBW-W-
BBBBB-B-B-B-B-B-B-B-B---B-B-B-B-B-B-B-B-BBBBB
-W-W-WBWBWBWBWBWBWBWBW-WBWBWBWBWBWBWBWBW-W-W-
BBBBBBB-B-B-B-B-B-B-B---B-B-B-B-B-B-B-BBBBBBB
-W-W-W-WBWBWBWBWBWBWBW-WBWBWBWBWBWBWBW-W-W-W-
BBBBBBBBB-B-B-B-B-B-B---B-B-B-B-B-B-BBBBBBBBB
-W-W-W-W-WBWBWBWBWBWBW-WBWBWBWBWBWBW-W-W-W-W-
BBBBBBBBBBB-B-B-B-B-B---B-B-B-B-B-BBBBBBBBBBB
-W-W-W-W-W-WBWBWBWBWBW-WBWBWBWBWBW-W-W-W-W-W-
BBBBBBBBBBBBB-B-B-B-B---B-B-B-B-BBBBBBBBBBBBB
-W-W-W-W-W-W-WBWBWBWBW-WBWBWBWBW-W-W-W-W-W-W-
BBBBBBBBBBBBBBB-B-B-B---B-B-B-BBBBBBBBBBBBBBB
-W-W-W-W-W-W-W-WBWBWBW-WBWBWBW-W-W-W-W-W-W-W-
BBBBBBBBBBBBBBBBB-B-B---B-B-BBBBBBBBBBBBBBBBB
-W-W-W-W-W-W-W-W-WBWBW-WBWBW-W-W-W-W-W-W-W-W-
BBBBBBBBBBBBBBBBBBB-B---B-BBBBBBBBBBBBBBBBBBB
-W-W-W-W-W-W-W-W-W-WBW-WBW-W-W-W-W-W-W-W-W-W-
BBBBBBBBBBBBBBBBBBBBB---BBBBBBBBBBBBBBBBBBBBB
-W-W-W-W-W-W-W-W-W-W-W-W-W-W-W-W-W-W-W-W-W-W-
---------------------------------------------
-W-W-W-W-W-W-W-W-W-W-W-W-W-W-W-W-W-W-W-W-W-W-
BBBBBBBBBBBBBBBBBBBBB---BBBBBBBBBBBBBBBBBBBBB
-W-W-W-W-W-W-W-W-W-WBW-WBW-W-W-W-W-W-W-W-W-W-
BBBBBBBBBBBBBBBBBBB-B---B-BBBBBBBBBBBBBBBBBBB
-W-W-W-W-W-W-W-W-WBWBW-WBWBW-W-W-W-W-W-W-W-W-
BBBBBBBBBBBBBBBBB-B-B---B-B-BBBBBBBBBBBBBBBBB
-W-W-W-W-W-W-W-WBWBWBW-WBWBWBW-W-W-W-W-W-W-W-
BBBBBBBBBBBBBBB-B-B-B---B-B-B-BBBBBBBBBBBBBBB
-W-W-W-W-W-W-WBWBWBWBW-WBWBWBWBW-W-W-W-W-W-W-
BBBBBBBBBBBBB-B-B-B-B---B-B-B-B-BBBBBBBBBBBBB
-W-W-W-W-W-WBWBWBWBWBW-WBWBWBWBWBW-W-W-W-W-W-
BBBBBBBBBBB-B-B-B-B-B---B-B-B-B-B-BBBBBBBBBBB
-W-W-W-W-WBWBWBWBWBWBW-WBWBWBWBWBWBW-W-W-W-W-
BBBBBBBBB-B-B-B-B-B-B---B-B-B-B-B-B-BBBBBBBBB
-W-W-W-WBWBWBWBWBWBWBW-WBWBWBWBWBWBWBW-W-W-W-
BBBBBBB-B-B-B-B-B-B-B---B-B-B-B-B-B-B-BBBBBBB
-W-W-WBWBWBWBWBWBWBWBW-WBWBWBWBWBWBWBWBW-W-W-
BBBBB-B-B-B-B-B-B-B-B---B-B-B-B-B-B-B-B-BBBBB
-W-WBWBWBWBWBWBWBWBWBW-WBWBWBWBWBWBWBWBWBW-W-
BBB-B-B-B-B-B-B-B-B-B---B-B-B-B-B-B-B-B-B-BBB
-WBWBWBWBWBWBWBWBWBWBW-WBWBWBWBWBWBWBWBWBWBW-
--B-B-B-B-B-B-B-B-B-B---B-B-B-B-B-B-B-B-B-B--
