--B-B-B-B--
-WBWBWBWBW-
BBB-B-B-BBB
-W-WBWBW-W-
BBBBB-BBBBB
-W-W-W-W-W-
BBBBB-BBBBB
-W-WBWBW-W-
BBB-B-B-BBB
-WBWBWBWBW-
--B-B-B-B--
