--B-B-B-B-B-B--
-WBWBWBWBWBWBW-
BBB-B-B-B-B-BBB
-W-WBWBWBWBW-W-
BBBBB-B-B-BBBBB
-W-W-WBWBW-W-W-
BBBBBBB-BBBBBBB
-W-W-W-W-W-W-W-
BBBBBBB-BBBBBBB
-W-W-WBWBW-W-W-
BBBBB-B-B-BBBBB
-W-WBWBWBWBW-W-
BBB-B-B-B-B-BBB
-WBWBWBWBWBWBW-
--B-B-B-B-B-B--
