--B-B-B---B-B-B--
-WBWBWBW-WBWBWBW-
BBB-B-B---B-B-BBB
-W-WBWBW-WBWBW-W-
BBBBB-B---B-BBBBB
-W-W-WBW-WBW-W-W-
BBBBBBB---BBBBBBB
-W-W-W-W-W-W-W-W-
-----------------
-W-W-W-W-W-W-W-W-
BBBBBBB---BBBBBBB
-W-W-WBW-WBW-W-W-
BBBBB-B---B-BBBBB
-W-WBWBW-WBWBW-W-
BBB-B-B---B-B-BBB
-WBWBWBW-WBWBWBW-
--B-B-B---B-B-B--
