--B-B-B-B-B-B-B-B---B-B-B-B-B-B-B-B--
-WBWBWBWBWBWBWBWBW-WBWBWBWBWBWBWBWBW-
BBB-B-B-B-B-B-B-B---B-B-B-B-B-B-B-BBB
-W-WBWBWBWBWBWBWBW-WBWBWBWBWBWBWBW-W-
BBBBB-B-B-B-B-B-B---B-B-B-B-B-B-BBBBB
-W-W-WBWBWBWBWBWBW-WBWBWBWBWBWBW-W-W-
BBBBBBB-B-B-B-B-B---B-B-B-B-B-BBBBBBB
-W-W-W-WBWBWBWBWBW-WBWBWBWBWBW-W-W-W-
BBBBBBBBB-B-B-B-B---B-B-B-B-BBBBBBBBB
-W-W-W-W-WBWBWBWBW-WBWBWBWBW-W-W-W-W-
BBBBBBBBBBB-B-B-B---B-B-B-BBBBBBBBBBB
-W-W-W-W-W-WBWBWBW-WBWBWBW-W-W-W-W-W-
BBBBBBBBBBBBB-B-B---B-B-BBBBBBBBBBBBB
-W-W-W-W-W-W-WBWBW-WBWBW-W-W-W-W-W-W-
BBBBBBBBBBBBBBB-B---B-BBBBBBBBBBBBBBB
-W-W-W-W-W-W-W-WBW-WBW-W-W-W-W-W-W-W-
BBBBBBBBBBBBBBBBB---BBBBBBBBBBBBBBBBB
-W-W-W-W-W-W-W-W-W-W-W-W-W-W-W-W-W-W-
-------------------------------------
-W-W-W-W-W-W-W-W-W-W-W-W-W-W-W-W-W-W-
BBBBBBBBBBBBBBBBB---BBBBBBBBBBBBBBBBB
-W-W-W-W-W-W-W-WBW-WBW-W-W-W-W-W-W-W-
BBBBBBBBBBBBBBB-B---B-BBBBBBBBBBBBBBB
-W-W-W-W-W-W-WBWBW-WBWBW-W-W-W-W-W-W-
BBBBBBBBBBBBB-B-B---B-B-BBBBBBBBBBBBB
-W-W-W-W-W-WBWBWBW-WBWBWBW-W-W-W-W-W-
BBBBBBBBBBB-B-B-B---B-B-B-BBBBBBBBBBB
-W-W-W-W-WBWBWBWBW-WBWBWBWBW-W-W-W-W-
BBBBBBBBB-B-B-B-B---B-B-B-B-BBBBBBBBB
-W-W-W-WBWBWBWBWBW-WBWBWBWBWBW-W-W-W-
BBBBBBB-B-B-B-B-B---B-B-B-B-B-BBBBBBB
-W-W-WBWBWBWBWBWBW-WBWBWBWBWBWBW-W-W-
BBBBB-B-B-B-B-B-B---B-B-B-B-B-B-BBBBB
-W-WBWBWBWBWBWBWBW-WBWBWBWBWBWBWBW-W-
BBB-B-B-B-B-B-B-B---B-B-B-B-B-B-B-BBB
-WBWBWBWBWBWBWBWBW-WBWBWBWBWBWBWBWBW-
--B-B-B-B-B-B-B-B---B-B-B-B-B-B-B-B--
