--B-B---B-B--
-WBWBW-WBWBW-
BBB-B---B-BBB
-W-WBW-WBW-W-
BBBBB---BBBBB
-W-W-W-W-W-W-
-------------
-W-W-W-W-W-W-
BBBBB---BBBBB
-W-WBW-WBW-W-
BBB-B---B-BBB
-WBWBW-WBWBW-
--B-B---B-B--
